$0-2
******************########################
******************########################
******************########################
******************########################
******************########################
******************########################
******************########################
******************########################
******************########################
******************########################
$3-6
******************************************
******************************************
******************************************
##########################################
##########################################
##########################################
##########################################
##########################################
##########################################
##########################################
$7-9
**************############################
**************############################
**************############################
**************############################
**************############################
**************############################
**************############################
**************############################
**************############################
**************############################
$10-21
******************************************
******************************************
******************************************
******************************************
*********************#####################
*********************#####################
*********#################################
*********#################################
*********#################################
*********#################################
$22-22
************************##################
************************##################
************************##################
************************##################
************************##################
************************##################
************************##################
************************##################
************************##################
************************##################
$23-31
*****##############################*******
*****##############################*******
*****##############################*******
*****##############################*******
*****##############################*******
*****##############################*******
*****##############################*******
*****##############################*******
*****##############################*******
*****##############################*******